11111110000000000000000000000000-
11111111100000000000000000000000-
11111111111000000000000000000000-
11111111111100000000000000000000-
11111111111111110000000000000000-
00001111111111111110000000000000-
00000001111111111111111100000000-
00000000111111111111111111111111-
00000000001111111111111111111111-
00000000000011111111111111111111-
00000000000000011111111111111111-
00000000000000000001111111111111-
00000000000000000000000000000000-
00000000000000000000000000000000-
00000000000000000000000000000000-
00000000000000000000000000000000

