11111111111111111111111111111111-
11111111111111111111111111111111-
11111111111111111111111111111111-
11111111111000000111111111111111-
11111111111000000011111111111111-
11111111111000000011111111111111-
11111111111100000011111111111111-
00111111111111111111111111111111-
00011111111111111111111111111111-
00011111111111111111111111111111-
00011111111111111111111111111111-
00001111111111111111111111111111-
00011111111000000000000000000000-
00111111110000000000000000000000-
01111111100000000000000000000000-
11111111000000000000000000000000

