11111100000000000000000001111111-
11111110000000000000000011111111-
11111111000000000000000111111111-
11111111100000000000001111111111-
11111111110000000000011111111111-
11111111111111111000111111111111-
11100111111111111000111111111111-
11100111111111111000111111111111-
11111111111111111111111111111111-
11111111111111111111111111111111-
00111111111111111111111111111111-
00111001000000011111111111111111-
11111001000000000000011111111111-
11111111000000000000011111111111-
11111111111111111111111111111111-
11111111111111111111111111111111

