111111111001111111111111111111111111111111111111111111111111111111111111-
111111110000000111111111111111111111111111111111111111111111111111111111-
111111110000111111111111111111111111111111111111111111111111111111111111-
111111110000111100001111111111111111111111111111111111111111111111111111-
111111111111111111111111111111111111111111111111111111111111111111111111-
111111111111111111111111111111111111111111111111111111111111111111111111-
100111111111111111111111111111111111111111111111111111111111111111111111-
100111111111111000011111111111111111111111111111111111111111111111111111-
110000111111111000011111111111111111111111111111111111111111111111111111-
111100000011111111111111111111111111111111111111111111111111111111111111-
111111111111111111111111111111111111111111111111111111111111111111111111-
111111111110000111111111111111111111111111111111111111111111111111111111-
111111111110000111111111111111111111111111111111111111111111111111111111-
111111111111111111111111111111111111111111111111111111111111111111111111-
111111111111111111111111111111111111111111111111111111111111111111111111-
111111111111111111111111111111111111111111111111111111111111111111111111-
111111111111111111111111111111111111111111111111111111111111111111111111-
111111111111111111111111111111111111111111111111111111111111111111111111-
111111111111111111111111111111111111111111111111111111111111111111111111
