11111111111111111111111111111111-
11111111111111111111111111111111-
11111111111111111111111111111111-
11111111100000011111111111111111-
11111111100000011111111111111111-
11111111100000011111111111111111-
11111111100000011111111111111111-
00111111111111111111111111111111-
00011111111111111111111111111111-
00011111111111111111111111111111-
00011111111111111111111111111111-
00111111111111111111111111111111-
00111111111111111111111111111111-
11111111111111100000000000000000-
11111111111111100000000000000000-
11111111111111100000000000000000

